█████████████████████████████████████████
S     █ █           █         █     █   █
█████ █ █ █████████ █ ███ ███ █ █ █ ███ █
█   █ █   █   █   █   █   █   █ █ █   █ █
█ ███ █ ███ █ █ █ █████ ███ █████ ███ █ █
█ █   █     █   █ █   █ █ █ █     █ █ █ █
█ █ ███████████████ █ █ █ █ █ █ ███ █ █ █
█ █           █     █   █   █ █ █ █   █ █
█ ███████████ █ █████████ ███ █ █ █ ███ █
█     █     █   █   █   █ █   █ █     █ █
█ ███ █ ███ █████ █ █ █ █ ███ █ █████ █ █
█ █ █   █ █     █ █   █ █   █ █   █ █   █
█ █ █████ ███ ███ █████ ███ █████ █ ███ █
█     █     █     █   █   █   █   █     █
█████ █████ ███████ █ ███ ███ █ ███ █████
█   █       █       █   █     █   █   █ █
█ █████████ █ ███████ █ ███████ █ ███ █ █
█     █     █   █   █ █     █   █ █ █   █
█ ███ █ █████████ █ █████ █ █████ █ ███ █
█   █             █       █       █    E█
█████████████████████████████████████████
