#########################################
S.#.......#...........#.....#...........#
#.#####.#.#######.###.#.#####.###.#####.#
#.......#...#.....#.....#...#...#.#...#.#
###########.#.###########.#.###.#.#.###.#
#.....#...#.#.....#.....#.#...#.#.#.....#
###.#.#.#.#.#.###.#.###.#.###.#.#.#.#####
#...#...#.#.#.#.#.#...#.#...#.#.#.#.#...#
#.#########.#.#.#.###.#.###.#.#.#.#.###.#
#...#.....#.#...#...#.#.....#...#.#.....#
#.#.#.###.#.###.###.#.###########.#####.#
#.#.#...#.#.#...#...#.#.........#...#.#.#
#.#.#.###.#.#.###.#.#.#####.###.###.#.#.#
#.#...#...#.#.#.#.#.#...#...#.....#.#.#.#
#.#####.###.#.#.#.#####.#.#####.###.#.#.#
#.#.#...#...#...#.....#.#.#...#.#...#...#
#.#.#.###.###########.#.#.#.#.###.###.###
#...#.....#.........#.....#.#.....#.#...#
###.#######.#######.#######.#######.###.#
#...........#...............#...........#
#############################E###########
